1 1 1 2 5 5 2 1 1 1 1 3 3 3 3 3
1 1 1 2 5 5 2 2 1 1 1 3 3 3 1 3
1 1 1 1 2 5 5 5 2 1 1 1 1 1 3 1
1 1 3 1 1 2 5 5 2 2 1 1 1 1 1 1
1 1 1 1 1 1 2 5 5 5 2 1 1 1 1 1
1 1 1 1 1 1 1 2 5 5 5 2 1 1 1 1
1 1 1 1 3 1 1 1 2 5 5 5 2 1 1 1
1 1 1 1 1 1 1 1 1 2 5 5 2 1 1 1
1 1 1 3 1 1 4 0 4 4 4 5 5 2 1 1
1 1 1 3 3 1 4 1 1 1 4 2 5 5 2 1
1 1 1 1 1 1 4 1 1 1 4 2 5 5 5 2
1 1 1 1 1 1 4 4 4 4 4 1 1 2 5 5